[layer]
type=Tile Layer 1
data=
1,1,1,1,1,1,1,1,1,1,1,
1,0,0,0,0,0,0,0,0,0,0,
1,1,1,1,1,1,1,1,1,0,0,
6,0,0,0,0,0,0,0,0,0,4,
0,0,1,1,1,1,1,1,1,1,1,
3,0,0,0,0,0,0,0,0,0,5,
1,1,1,1,1,1,1,1,1,0,4,
0,0,0,0,0,0,0,0,0,0,0,
0,0,0,0,0,0,0,0,0,0,0,
0,0,0,0,0,0,0,0,0,0,0,
0,0,0,0,0,0,0,0,0,0,0.
[layer]
type=Tile Layer 2
data=
5,5,5,5,5,5,5,5,5,5,5,
5,0,0,0,0,0,0,0,0,0,5,
5,15,15,15,15,15,15,15,15,0,5,
5,0,0,0,0,0,0,0,0,0,5,
5,0,15,15,15,15,15,15,15,15,5,
5,0,0,0,0,0,0,0,0,0,5,
10,10,10,10,10,10,10,10,10,0,10,
0,0,0,0,0,0,0,0,0,0,0,
0,0,0,0,0,0,0,0,0,0,0,
0,0,0,0,0,0,0,0,0,0,0,
0,0,0,0,0,0,0,0,0,0,0.
